ABAABAABAABAABAABAABAABA
AABBAAAABBAAAABBAAAABBAA
ABAABAABAABAABAABAABAABA
BAABAABAABAABAABAABAABAA
ABAABAABAABAABAABAABAABA
ABAABAABAABAABAABAABAABA
AABBAAAABBAAAABBAAAABBAA
ABAABAABAABAABAABAABAABA
ABAABAABAABAABAABAABAABA
AABBAAAABBAAAABBAAAABBAA
ABAABAABAABAABAABAABAABA
BAABAABAABAABAABAABAABAA
ABAABAABAABAABAABAABAABA
ABAABAABAABAABAABAABAABA
AABBAAAABBAAAABBAAAABBAA
